#####################
#   # #   #   #   # #
### # # # # # # ### #
#     # # # # #     #
# ### ### # ##### ###
# # #   #     #     #
# # # ##### ### #####
# #    A# #         #
# # # ### ##### # ###
# # #           # # #
### ####### ####### #
#   # #           # #
# ### # ########### #
#   # #   #       # #
# # # ##### ### ### #
# #     #   #   #   #
# ############# ### #
#         #     #   #
####### # # ### # # #
#       #     #   # #
##################### 