#####################
      #       #     #
# # # ##### # ### ###
# # # # #A# #     # #
### # # # # ### ### #
#   # #     #     # #
# ######### # ### # #
#   # #     # #     #
### # # ##### ### ###
# # #     #   #     #
# # ##### ####### # #
# #   #       #   # #
# # ##### ##### ### #
#   #     #     #   #
### # ##### ##### # #
#         #   #   # #
# ################# #
#     #       #     #
# ##### ### ####### #
#       #     #     #
#####################
