#####################
#A    #       # #   #
### ##### ##### ### #
#   #           # # #
### # ####### ### # #
#   # # #           #
# ##### ### ##### ###
# # #   #       #   #
# # ### ### ### #####
#       # # #       #
####### # ##### # ###
# #           # #   #
# ### ##### ### ### #
#   # # # #     #   #
# # # # # ##### ### #
# # # # #   # #   # #
### # # # ### ##### #
# # #           #   #
# # ### # ### ##### #
#       #   # #     #
##################### 