#####################
#     # #           #
### # # ### #########
#   # # #   #       #
# # # # ### # ##### #
# # #         # # #A#
##### ### ### # # ###
#       #   #     # #
# # ### # ##### ### #
# # #   # #     #   #
######### ##### # ###
# # # # #     # #   #
# # # # ### ##### ###
#   #   # #         #
# ##### # ### ##### #
#   #   #   # #     #
# ### # # ### #######
#   # #       #   # #
### # ##### # # # # #
#     #     #   #   #
#####################
