#####################
#     #   #   # # # #
##### ### ####### # #
# #       #       # #
# # # ########### # #
# # #         # # # #
# ##### ### # # # ###
#       # # # # #  A#
# ##### # ##### # ###
# #                 #
# ####### # # ##### #
#       # # #   #   #
#####################
